u'*班级类型一旦选择不可更改': '*Class type cannot be changed after chosen',
u'*课程类型一旦选择不可更改': '*Lesson type cannot be changed after chosen',
u'*老师帐号找回密码请联系机构管理员': '*Please contact school administrator to retrieve teacher’s password ',
u'- 计时规则：新购教室（指直接购买2.0教室，非1.0升级、非续费）以教室首次初始化开始计时；从1.0升级到2.0的教室，以及后续续费，从订单“申请发货”开始计时': 'Timing rule: New purchased classroom (new purchased 2.0 version classroom, not 1.0 upgrade version classroom) will start timing after the first initialization. Classrooms updated to 2.0 from 1.0 and renewed classrooms will start timing from order’s “apply shipments”',
u'- 系统使用权限是指教学系统是否可以使用，在有系统使用权限的前提下可以使用已购买的课程': 'System access means teaching system is functional and able to use purchased lesson',
u'- 系统维护费到期未续费，系统将无法使用，原先拥有的课程权限继续保留，续费成功后，可以继续使用尚未过期的课程': 'System cannot be used until the maintenance fee is paid. The lessons’ access will be saved, and will be usable after it’s being paid.',
u'0.未开课': 'Class pending',
u'Excel {row}行，{col}列：{val}，{msg}, 请重新上传': 'Excel {row}row，{col}column：{val}，{msg}, Please upload again',
u'Excel 行数不能超过500': 'Excel maximum number of rows is 500',
u'Excel 用户名列所填内容不能重复，请检查后重新上传': 'Excel username list can not be repeated, please check and upload again.',
u'The ONE智能音乐教室资料库': 'The ONE Smart Piano Classroom database',
u'email不能为空': 'Email cannot be empty',
u'email格式不正确': 'Email format is incorrect',
u'无分句PK': 'None pieces' duel',
u'无分句PK': 'None pieces' duel',
u'月': 'Month',
u'日': 'Day',
u'(体验班)': '(open house)',
u'(体验课)': '(open house lesson)',
u'{}学生列表.xls': '{}student list.xls',
u'© The ONE 智能音乐教室': '© The ONE Smart Piano Classroom',
u'©The ONE 智能音乐教室': '©The ONE Smart Piano Classroom',
u'女': 'Female',
u'无': 'None',
u'男': 'Male',
u'页': 'Page',
u'与 The ONE 共同成长': 'Get better with The ONE',
u'取 消': 'Cancel',
u'完 成': 'Finish',
u'登 录': 'Login',
u'乐理': 'Music theory',
u'位置': 'Location',
u'保存': 'Save',
u'修改': 'Modify',
u'入门': 'Beginning',
u'全部': 'All',
u'关闭': 'Close',
u'初学': 'Primer',
u'删除': 'Delete',
u'取消': 'Cancel',
u'听力': 'Aural',
u'在职': 'Employed',
u'在读': 'Full-time student',
u'备注': 'Memo',
u'姓名': 'Name',
u'完成': 'Ok',
u'密码': 'Password',
u'年龄': 'Age',
u'性别': 'Gender',
u'总分': 'Points',
u'所有': 'All',
u'提交': 'Submit',
u'操作': 'Operation',
u'教室': 'Classroom',
u'新建': 'New',
u'昵称': 'Nickname',
u'更多': 'More',
u'查找': 'Search',
u'查看': 'View',
u'标题': 'Tittle',
u'演奏': 'Play',
u'熟练': 'Proficient',
u'版本': 'Version',
u'状态': 'Status',
u'班级': 'Class',
u'生日': 'Birthday',
u'电话': 'Phone',
u'确定': 'Ok',
u'确认': 'Confirm',
u'管理': 'Manage',
u'规模': 'Size',
u'评价': 'Comment',
u'跳至': 'Skip to',
u'返回': 'Return',
u'还原': 'Restore',
u'退出': 'Exit',
u'首页': 'Homepage',
u'系统/教师评分': 'System/teacher's evaluation',
u'总数:': 'Sum:',
u'家长Email': 'Parent's email',
u'上传Excel列表': 'Upload Excel list',
u'导出Excel列表': 'Export Excel list',
u'设备ID': 'Device's ID',
u'钢琴ID': 'Piano's ID',
u'全曲PK': 'Duel',
u'分句PK': 'Pieces' duel',
u'卡拉PK': 'Rhythm game duel',
u'无灯PK': 'Non-LED light duel',
u'曲谱PK': 'Duel',
u'曲谱PK(中速)': 'Duel (Slow pace)',
u'曲谱PK(原速)': 'Duel (Regular pace)',
u'曲谱PK(慢速)': 'Duel (Extra slow pace)',
u'家长email': 'Parent's email',
u'上一页': 'Previous page',
u'下一页': 'Next page',
u'不评价': 'No comment',
u'优惠码': 'Coupon code',
u'体验班': 'Trial class',
u'使用中': 'Using',
u'出勤率': 'Attendance rate',
u'原密码': 'Old password',
u'图例：': 'Figure:',
u'已验证': 'Verified',
u'待使用': 'Waiting',
u'成绩单': 'Report',
u'新密码': 'New password',
u'未分配': 'Undistributed',
u'未购买': 'Unpurchased',
u'未验证': 'Unverified',
u'正式班': 'Standard class',
u'用户名': 'Username',
u'移动至': 'Move to',
u'联系人': 'Contact',
u'说明：': 'Description:',
u'请选择': 'Please select',
u'零基础': 'New learner',
u'验证码': 'Verification code',
u'状态：': 'Status:',
u'本课无PK/小考核': 'This lesson doesn't have duels/tests',
u'教室：': 'Classroom：',
u'学生': 'Student',
u'人': '保留空白',
u'上课时间': 'Time for class',
u'下载模板': 'Download template',
u'任课老师': 'Instructor',
u'修改密码': 'Change password',
u'儿童课程': '不翻译',
u'分配班级': 'Distribute classes',
u'创建时间': 'Create date',
u'即将到期': 'Expiring',
u'售后热线': 'Customer service',
u'学习时间': 'Time for study',
u'学习课程': 'Study lesson',
u'学习进度': 'Study progress',
u'学生信息': 'Student information',
u'学生列表': 'Student list',
u'学生姓名': 'Student name',
u'学生成绩': 'Student report',
u'学生点评': 'Student feedback',
u'家长姓名': 'Parent's name',
u'家长电话': 'Parent's phone',
u'密码错误': 'Password incorrect',
u'已有学生': 'Already have student',
u'常见问题': 'FAQ',
u'当前状态': 'Current status',
u'怀旧金曲': 'Classic songs',
u'意见反馈': 'Feedback',
u'所在班级': 'Class NO.',
u'手机号码': 'Cell phone',
u'批量删除': 'Batch delete',
u'找回密码': 'Recover password',
u'教室信息': 'Classroom information',
u'教室名称': 'Classroom name',
u'教室容量': 'Classroom capacity',
u'教室管理': 'Classroom manage',
u'教师信息': 'Teacher's information',
u'教师列表': 'Teacher list',
u'教师姓名': 'Teacher name',
u'教师评价': 'Teacher's evaluation',
u'教育类型': 'Education type',
u'新建学生': 'New student',
u'新建教师': 'New teacher',
u'新建班级': 'New class',
u'暂无成绩': 'No report',
u'更新时间': 'Update time',
u'最新成绩': 'Latest report',
u'机构名称': 'School's Name',
u'正常上课': 'Attend class',
u'正常开课': 'Start class',
u'每页显示': 'Page display',
u'流行经典': 'Popular classic songs',
u'班级人数': 'Student number',
u'班级名称': 'Class name',
u'班级管理': 'Class manage',
u'班级类型': 'Class type',
u'班级设置': 'Class setting',
u'确认删除': 'Delete',
u'确认密码': 'Ok',
u'确认添加': 'Ok',
u'系统评分': 'System grade',
u'联系电话': 'Contact information',
u'自动登陆': 'Auto login',
u'课堂点评': 'Class review',
u'课程类型': 'Lesson type',
u'账号信息': 'Account information',
u'账号安全': 'Account security',
u'账号设置': 'Account setting',
u'身份验证': 'Phone number verification',
u'重置密码': 'Reset password',
u'钢琴教室': 'Piano classroom',
u'钢琴水平': 'Piano level',
u'音乐教室': 'Music classroom',
u'验证成功': 'Verified',
u'机构信息': ' 若需更改机构信息，请与管理员联系',
u'上传图片(或附件）': 'Upload picture (or attach file)',
u'已有学生:': 'Existing students',
u'安卓设备ID': 'Android device ID',
u'欢迎您：': 'Welcome：',
u'使用到期日': 'Expired on ',
u'修改成功！': 'Successfully modified!',
u'发送验证码': 'Send verification code',
u'威尔第雪山': 'Verdi Snowy Mountain',
u'学生不存在': 'Student does not exist',
u'已处理评价': 'Feedback reviewed',
u'已验证学生': 'Student verified',
u'待处理评价': 'Pending feedback',
u'教师不存在': 'Teacher does not exist',
u'未验证学生': 'Unverified student',
u'爱丽丝小镇': 'Alice Town',
u'班级不存在': 'Class does not exist',
u'系统维护费': 'System maintenance fee',
u'索拉朵之海': 'Sea Sollado',
u'联系方式：': 'Contact information:',
u'请输入分数': 'Please enter the score',
u'请输入评语': 'Please enter a feedback',
u'请选择性别': 'Please select the gender',
u'重置成功！': 'Reset successful',
u'验证码无效': 'Verification code invalid',
u'班级类型：': 'Class type:',
u'分数请输入 0-100 之间的整数': 'Please enter a whole number between 0-100 for the score',
u'感谢您选择 The ONE': 'Thank you for choosing The ONE',
u'生日格式：1990/01/07': 'Birthday format: 1990/01/07',
u'注：儿童课2.0版、成人课、老年课，分别从课程第一次“开始上课“开始计时。': 'Note: Children course, adult course and elder course will start timing after the first "Class begin"',
u'开课日期：2015/8/26（周日）': 'Class start date: 2015/8/26 (Sunday)',
u'姓名长度在2~20之间': 'Please keep the name character length between 2-20',
u'姓名长度在2~20之间，中文和字母，不包含数字': 'Please keep the name character length between 2-20, this does not include numbers',
u'已验证学生:': 'Authorized student:',
u'未验证学生:': 'Unauthorized student:',
u'班级数量：': 'Class number：',
u'所在班级：': 'Current class：',
u'任课教师：': 'Course teacher：',
u'教室数量：': 'Classroom number：',
u'教室数量：': 'Classroom number：',
u'教师数量：': 'Teacher number：',
u'优惠码说明：': 'Coupon code intro:',
u'修改手机号码': 'Change cell phone number',
u'删除学生错误': 'Delete error student',
u'删除班级错误': 'Delete error class',
u'删除老师错误': 'Delete error teacher',
u'原密码不正确': 'Old password incorrect',
u'发生未知错误': 'Unknown error detected',
u'后台存储错误': 'Background storage error',
u'备注名称过长': 'Memo name's length exceeded',
u'姓名不能为空': 'Name cannot be empty',
u'学生成绩查询': 'Student report inquire',
u'学生账号管理': 'Student account management',
u'密码不能为空': 'Password cannot be empty',
u'开始使用日期': 'Start date',
u'成功删除学生': 'Student deleted',
u'成功删除班级': 'Class deleted',
u'成功删除老师': 'Teacher deleted',
u'教师账号管理': 'Teacher account management',
u'机构管理系统': 'School management system',
u'班级名称过长': 'Class name is too long',
u'班级开课时间': 'Class start date',
u'用户名不存在': 'Username does not exist',
u'用户已被禁用': 'This account has been banned',
u'禁止删除自己': 'Unable to delete your account',
u'秒后重新发送': 'Resend after # seconds',
u'系统使用权限': 'System permission',
u'该学生不存在': 'Student does not exist',
u'该教室不存在': 'Classroom does not exist',
u'该教师不存在': 'Teacher does not exist',
u'该班级不存在': 'Class does not exist',
u'该老师不存在': 'Teacher does not exist',
u'身份验证成功': 'Authentication successful',
u'输入不能为空': 'Input cannot be empty',
u'选择班级类型': 'Please choose a class type',
u'钢琴教室管理': 'Piano classroom management',
u'首次任课时间': 'First time of teaching',
u'验证手机号码': 'Verify the phone number',
u'验证码不正确': 'Incorrect verification code',
u'性别填写：男 或 女': 'Gender: Male or Female',
u'用户名不存在! (机构代码.用户名）': 'Username does not exist (school code. Username)',
u'请输入正确的6位手机验证码': 'Please enter the correct 6 digits phone verification code',
u'请输入正确的6位短信验证码': 'Please enter the correct 6 SMS phone verification code',
u'成功创建老师: {}, 请用默认密码{}登陆': 'Teacher create successful: {}, Please use the default password to{}login',
u'成功创建学生:{}，默认登陆密码为:{}': 'Student create successful:{}，Default login password:{}',
u'待点评数量：{{ pagination.total }}个': 'Numbers of pending review：{{ pagination.total }}个',
u'上一次上课时间': 'Last class time',
u'上一次任课时间': 'Last teaching time',
u'上次初始化时间': 'Last initialization time',
u'不存在这个班级': 'Class does not exist',
u'感谢您的反馈！': 'Thank you for your feedback!',
u'教学示范与支持': 'Teaching demo and support',
u'暂无可分配学生': 'All students are assigned',
u'未选择班级类型': 'Class type need to be selected',
u'班级名称已存在': 'Class name already existed',
u'用户名不能为空': 'Username cannot be empty',
u'确定不评价吗？': 'No feedback?',
u'该手机号码有效': 'Phone number valid',
u'该手机好已存在': 'Phone number already existed',
u'该班级暂无学生': 'No students are in this class',
u'请添加文字描述': 'Please enter a description',
u'请输入手机号！': 'Please enter a phone number!',
u'请选择班级类型': 'Please select a class type',
u'首次初始化时间': 'First initialization date',
u'成功创建班级：%s': 'Class created : %s',
u'成功删除学生：%s': 'Student deleted: %s ',
u'成功删除老师：%s': 'Teacher deleted : %s',
u'成功更改班级：%s': 'Class changed : %s',
u'成功更改老师：%s': 'Teacher changed :%s',
u'已成功修改密码,请重新登录': 'Your password has been changed. Please login again.',
u'教室名字长度在2~20之间': 'Choose a class name that is 2-20 characters long.',
u'家长姓名不能为空': 'Parent names required.',
u'家长电话不能为空': 'Parent mobile number required.',
u'尤克里里教室管理': 'Ukulele classroom management',
u'成功移动所选学生': 'Student has been moved successfully.',
u'手机号码不能为空': 'Mobile number required.',
u'手机号码验证成功': 'Mobile number verification succeeded.',
u'机构名称不能为空': 'School name required.',
u'班级名称不能为空': 'Class name required.',
u'确定推送评价：': 'Feedback send: ',
u'获取班级信息失败': 'Unable to acquire class information.',
u'该手机号码已存在': 'Mobile number exists.',
u'请输入机构代码！': 'Please enter school code.',
u'请输入评语和分数': 'Please provide feedback and performance scores.',
u'请选择班级类型！': 'Please select the class.',
u'已成功修改老师：%s': 'Teacher modification succeeded：%s',
u'成功添加了学生：%s': 'Student has been added successfully:：%s',
u'进度：我的旅途－3.林间小路': 'Progress: My journey-3.Path Through the Woods',
u'评语长度不能超过70个字': 'The maximum length of feedback message that you can send is 70 characters. ',
u'不存在的机构代码:': '%s School code does not exist:%s.',
u'进度：我的旅途－{{ data[0].number }}.{{ data[0].lesson }}': 'Progress: My journey－{{ data[0].number }}.{{ data[0].lesson }}',
u'已完成点评数量：{{ pagination.total }}个': 'Reviews completed：{{ pagination.total }}个',
u'进度：我的旅途－{{ sessions[0].number }}.{{ sessions[0].lesson }}': 'Progress: My journey－{{ sessions[0].number }}.{{ sessions[0].lesson }}',
u'不包含钢琴音乐教室': 'Does not contain piano music classroom',
u'不能和其他教室重名': 'This entry cannot have the same name with other class.',
u'两次输入密码不一致': 'The passwords you entered do not match.',
u'两次输入密码需相同': 'Passwords need to match.',
u'只能为中文英文字符': 'This entry can only contain Chinese and English letters.',
u'扫描二维码推送成绩': 'Scan the QR Code to send the lesson results.',
u'确定要放弃评价吗？': 'Are you sure you want to leave the comment page?',
u'验证码错误或已过期': 'Verification code is incorrect or has been expired.',
u'成功更改同学信息：%s': 'Student information has been updated successfully:：%s',
u'成功更改为默认密码: %s': 'Default password has been changed successfully: %s',
u'任老师您好，您还有xx个学生未进行评价': 'Ms.Ren, you have xx more students that needs be evaluated',
u'默认填写机构联系电话': 'Choose the default contact information.',
u'请添加正确的文件格式,仅支持{}': 'Please select the correct file format. You can upload a {} file.',
u'请输入正确的手机号码！': 'Please enter the correct mobile number.',
u'上传图片或附件（不超过8MB，任意格式）': 'Upload a picture or a file (maximum size: 8 MB).',
u'发验证码失败，请稍后再试': 'Verification code failed to send, please try again later.',
u'输入的手机号不符合规范！': 'This entry can only contain numbers.',
u'验证码不正确，请重新输入': 'Verification code you entered is incorrect, please try again.',
u'只能为英文大小写，数字，"_"和"-"': 'This entry can only contain lowercase or capital letters, numbers, "_" and "-".',
u'输入的手机号码不符合规范！': 'This entry can only contain numbers.',
u'上传文件格式不正确，只支持.xlsx, xls': 'Please select the correct file format. You can upload a .xlsx or xls file.',
u'手机号码格式不正确，请填写11位手机号码': 'Please enter a 10-digital number.',
u'未验证学生不能移动到正式班级': 'Unverified student cannot be moved to the official class.',
u'该手机号已被占用，请重新输入': 'This mobile number has been registered. Please check.',
u'请先输入手机获取短信验证码！': 'Please enter your mobile number to obtain the verification code.',
u'请点击复选框选中要删除的学生': 'Please click the check box to select the students you want to delete',
u'请点击复选框选中要删除的老师': 'Please click the check box to select the teachers you want to delete',
u'请点击复选框选中要移动的学生': 'Please click the check box to select the students you want to move',
u'列数量不正确，请检查后重新上传': 'The number of rows is incorrect, please check and re-upload',
u'删除自己将产生错误，禁止该操作': 'Please do not delete yourself, otherwise it will produce an error',
u'该手机号码已被占用，请重新输入': 'This mobile number has been registered. Please check.',
u'该班级所在教室容纳不了所选学生': 'The number of students in this class has exceeded the maximum numbers.',
u'班级里存在未验证的学生，请先验证': 'Class contains unverified student, please verify first.',
u'当前班级的总人数已经超出教室钢琴数,请添加钢琴': 'The number of pianos and students mismatched. Please add piano. ',
u'班级学生数超出教室钢琴数，请减少学生': 'The number of pianos and students mismatched, please reduce some students',
u'用户名已被占用，不可还原，请重新创建。': 'This username has been already taken. Please create a new account.',
u'该用户名在该机构已经被使用，请更换用户名': 'Username exists in this school. Please change your username.',
u'输入的手机号已经被占用，请检查后重新输入！': 'This mobile number has been registered. Please check.',
u'所选教室未开通任何课程，请更换教室或购买课程': 'No course has been activated under this class, please switch to another class or purchase the course.',
u'用户名以字母开头，只能含有数字字母下划线，长度在3~32之间': 'Choose a username that is 3-32 characters long and must start with a lowercase or capital letter. User name can contain numbers and underlines.',
u'删除班级会导致该班学生变为未分配班级状态，确认删除？': 'Deleting the class will cause an unassigned class situation. Are you sure you want to delete this class?',
u'用户名已经存在于该机构。注：也不能同已删除用户名相同': 'Username exists in this school. Note: This entry cannot have the same name with the deactivated user.',
u'输入文字过长，请尝试使用附件上传的方式进行长文本编辑': 'You have exceeded the maximum characters limit. Please try to upload attachment to edit.',
u'请在下方输入您的意见或建议，我们将非常认真对待每一条反馈，谢谢！': 'We would greatly appreciate if you can leave your comments and suggestions below.',
